33333333333333333333333333333333333333333333333333
30000000000000000000000000000000000000000000000003
30000000000000000000000000000000000000000000000003
30000000000000000000000000000000000000000000000003
30000000000000000000000000000000000000000000000003
30000000000000000000000000000000000000000000000003
30000000000000000000000000000000000000000000000003
30000000000000111111000000000000000000000000000003
30000000000000111111000000000000000000000000000003
30000000000000111111000000000000000000000000000003
30000000000000000000000000000000000000000000000003
30000000000000000000000000000000000000000000000003
33333333333333333333333320000000000000000000000003
30000000000000000000000000000000000000000000000003
30000000000000000000000000000000000000000000000003
30000000000000000000000000000000000000000000000003
30000000000000000002333333333333333333333333333333
30000000000000000000000000000000000000000000000003
30000000000000000000000000000000000000000000000003
30000000000000000000000000000000000000000000000003
30000000000000000000000000000000000000000000000003
30000000000000000000000000000000000000000000000003
30000000000000000000000000000000000000000000000003
30000000000000000000000000000000000000000000000003
30000000000000000000000000000000000000000000000003
30000000000000000000000000000000000000000000000003
30000000000000000000000000000000000000000000000003
30000000000000000000000000000000000000000000000003
30000000000000000000000000000000000000000000000003
30000000000000000000000000000000000000000000000003
30000000000000000000000000000000000000000000000003
30000000000000000000000000000000000000000000000003
30000000000000000000000000000000000000000000000003
30000000000000000000000000000000000000000000000003
30000000000000000000000000000000000000000000000003
30000000000000000000000000000000000000000000000003
30000000000000000000000000000000000000000000000003
30000000000000000000000000000000000000000000000003
30000000000000000000000000000000000000000000000003
33333333333333333333333333333333333333333333333333
