3333333333333333333333333333333333333333333333333333333333333333333333333333333333333333333333333333
3000000000000000000000000000000000000000000000000333333333333333333333333333333333333333333333333333
3000000000000000000000000000000000000000000000000333333333333333333333333333333333333333333333333333
3000000000000000000000000000000000000000000000000333333333333333333333333333333333333333333333333333
3000000000000000000000000000000000000000000000000333333333333333333333333333333333333333333333333333
3000000000000000000000000000000000000000000000000333333333333333333333333333333333333333333333333333
3000000000000000000000000000000000000000000000000333333333333333333333333333333333333333333333333333
3000000000000011111100000000000000000000000000000333333333333333333333333333333333333333333333333333
3000000000000011111100000000000000000000000000000333333333333333333333333333333333333333333333333333
3000000000000011111100000000000000000000000000000333333333333333333333333333333333333333333333333333
3000000000000000000000000000000000000000000000000333333333333333333333333333333333333333333333333333
3000000000000000000000000000000000000000000000000333333333333333333333333333333333333333333333333333
3333333333333333333333332000000000000000000000000333333333333333333333333333333333333333333333333333
3000000000000000000000000000000000000000000000000333333333333333333333333333333333333333333333333333
3000000000000000000000000000000000000000000000000333333333333333333333333333333333333333333333333333
3000000000000000000000000000000000000000000000000333333333333333333333333333333333333333333333333333
3000000000000000000233333333333333333333333333333333333333333333333333333333333333333333333333333333
3000000000000000000000000000000000000000000000000333333333333333333333333333333333333333333333333333
3000000000000000000000000000000000000000000000000333333333333333333333333333333333333333333333333333
3000000000000000000000000000000000000000000000000333333333333333333333333333333333333333333333333333
3000000000000000000000000000000000000000000000000333333333333333333333333333333333333333333333333333
3000000000000000000000000000000000000000000000000333333333333333333333333333333333333333333333333333
3000000000000000000000000000000000000000000000000333333333333333333333333333333333333333333333333333
3000000000000000000000000000000000000000000000000333333333333333333333333333333333333333333333333333
3000000000000000000000000000000000000000000000000333333333333333333333333333333333333333333333333333
3000000000000000000000000000000000000000000000000333333333333333333333333333333333333333333333333333
3000000000000000000000000000000000000000000000000333333333333333333333333333333333333333333333333333
3000000000000000000000000000000000000000000000000333333333333333333333333333333333333333333333333333
3000000000000000000000000000000000000000000000000333333333333333333333333333333333333333333333333333
3000000000000000000000000000000000000000000000000333333333333333333333333333333333333333333333333333
3000000000000000000000000000000000000000000000000333333333333333333333333333333333333333333333333333
3000000000000000000000000000000000000000000000000333333333333333333333333333333333333333333333333333
3000000000000000000000000000000000000000000000000333333333333333333333333333333333333333333333333333
3000000000000000000000000000000000000000000000000333333333333333333333333333333333333333333333333333
3000000000000000000000000000000000000000000000000333333333333333333333333333333333333333333333333333
3000000000000000000000000000000000000000000000000333333333333333333333333333333333333333333333333333
3000000000000000000000000000000000000000000000000333333333333333333333333333333333333333333333333333
3000000000000000000000000000000000000000000000000333333333333333333333333333333333333333333333333333
3000000000000000000000000000000000000000000000000333333333333333333333333333333333333333333333333333
3333333333333333333333333333333333333333333333333333333333333333333333333333333333333333333333333333
