3333333333333333333333333333333333333333333333333333333333333333333333333333333333333333333333333333
3000300000000000000000000000000000000000000000000333333333333333333333333333333333333333333333333333
3000300000000000000000000000000000000000000000000333333333333333333333333333333333333333333333333333
3000300000000000000000000000000000000000000000000333333333333333333333333333333333333333333333333333
3000300000000000000000000000000000000000000000000333333333333333333333333333333333333333333333333333
3000333300000000000000000000000000000000000000000333333333333333333333333333333333333333333333333333
3000000000000000000000000000000000000000000000000333333333333333333333333333333333333333333333333333
3000300000000011111100000000000000000000000000000333333333333333333333333333333333333333333333333333
3000000000000011111100000000000000000000000000000333333333333333333333333333333333333333333333333333
3000000000000011111100000000000000000000000000000330000000000000000000000000000000000000000000000000
3000000000000000000000000000000000000000000000000333333333333333333333333333333333333333333333333333
3000000000000000000000000000000000000000000000000333333333333333333333333333333333333333333333333333
3333333333333333333333332300000000000000000000000333333333333333333333333333333333333333333333333333
3000000000000000000000000000000000000000000000000333333333333333333333333333333333333333333333333333
3000000000000000000000000000000000000000000000000333333333333333333333333333333333333333333333333333
3000000000000000000000000000000000000000000000000333333333333333333333333333333333333333333333333333
3000000000000000000233333333333333333333333333333333333333333333333333333333333333333333333333333333
3000000000000000000000000000000000000000000000000333333333333333333333333333333333333333333333333333
3000000000000000000000000000000000000000000000000333333333333333333333333333333333333333333333333333
3000000000000000000000000000000000000000000000000333333333333333333333333333333333333333333333333333
3000000000000000000000000000000000000000000000000333333333333333333333333333333333333333333333333333
3000000000000000000000000000000000000000000000000330000000000000000000000000000000000000000000000000
3000000000000000000000000000000000000000000000000333333333333333333333333333333333333333333333333333
3000000000000000000000000000000000000000000000000333333333333333333333333333333333333333333333333333
3000000000000000000000000000000000000000000000000333333333333333333333333333333333333333333333333333
3000000000000000000000000000000000000000000000000333333333333333333333333333333333333333333333333333
3000000000000000000000000000000000000000000000000333333333333333333333333333333333333333333333333333
3000000000000000000000000000000000000000000000000333333333333333333333333333333333333333333333333333
3000000000000000000000000000000000000000000000000333333333333333333333333333333333333333333333333333
3000000000000000000000000000000000000000000000000333333333333333333333333333333333333333333333333333
3000000000000000000000000000000000000000000000000330000000000000000000000000000000000000000000000000
3000000000000000000000000000000000000000000000000333333333333333333333333333333333333333333333333333
3000000000000000000000000000000000000000000000000333333333333333333333333333333333333333333333333333
3000000000000000000000000000000000000000000000000333333333333333333333333333333333333333333333333333
3000000000000000000000000000000000000000000000000333333333333333333333333333333333333333333333333333
3000000000000000000000000000000000000000000000000333333333333333333333333333333333333333333333333333
3000000000000000000000000000000000000000000000000333000000000000000000000000000000000000000000000000
3000000000000000000000000000000000000000000000000333333333333333333333333333333333333333333333333333
3000000000000000000000000000000000000000000000000000000000000000000000000000000000000000000000000003
3333333333333333333333333333333333333333333333333333333333333333333333333333333333333333333333333333
